0000000000000000000007EEEEEE5000000000000000000000000000000000
0000000000000000000007EEEA663000000000000000000000000000000000
00004888888100000000026663000000000000000000000000000000000000
00007EEEEEE500000000000000000000000000000000000000000000000000
00007EEEEEE500000000000000000000000000488888888100000000000000
00007EEEEEE500000000000000000000000488CEEEEEEEE500000000000000
00007EEEEEED888100041000000000000007EEEEEEEEEEE500000000000000
0000266BEEEEEEE500023000000000000007EEEEEEEEEEE500000000000000
00000007EEEEEEE500000000000000000002666BEEEA666300000000000000
0000000266666663000000000000000000000007EEE5000000000000000000
00000000000000000000000000000000000000026663000000000000000000
00000000000000000000000000000000000000000000000000000000000000
00000000000000000000000000000000000000000000000000000000000000
00000000000000000000000000000000000000000000000000000000000000
00000000000000048888100000000000000000000000000000000000000000
00000000000000026666300000000000000000000000000000000000000000
00000000000000000000000000000000000000000000000000000000000000
00000000000000000000000000000000000000000000000000000000000000
00000000000000000000000000000000004888810000000000000000000000
00000000000000000000000000000000007EEEE50000000000000000000000
00000000000000000000000000000000007EEEE50000000000000000000000
00000000000000000000000000000000007EEEE50000000000000000000000
00000000000000000000000000000000007EEEE50000000000000000000000
0000000000004888810000000000000000266BE50000000000000000000000
0000000000007EEEE500000000000000000007ED8881000000000000000000
00000000000026666300000000000000000007EEEEE5000000000000000000
0000000000000000000000000000000000488CEEEEE5000000000000000000
00000000000000000000000000000000007EEEEEA663000000000000000000
00000000000000000000000000000000007EEEEE5000000000000000000000
00000000000000000000000000000000007EEEEE5000000000000000000000
00000000000000000000000000000000007EEEEE5000000000000000000000
00000000000000000000000000000000002666663000000000000000000000
00000000000000000000000000000000000000000000000000000000000000
00000000000000000000000000000000000000000000000000000000000000
00000000000000000000000000000000000000000000000000000000000000
00000000000000000000000000000000000000000000000000000000000000
00000000000000000000000000000000000000000000000000000000000000
00000000000000000000000000000000000000000000000000000000000000
00000000000000000000000000000000000000004888810000000000000000
00000000000000000000000000000000000000007EEEE50000000000000000
00000000000000000000000000000000000000002666630000000000000000
00000000000000000000000000000000000000000000000000000000000000
00000000000000000000000000000000000000000000000000000000000000
00000000000000000000000000000000000000000000000000000000000000
00000000000000000000000000000000000000000000000000000000000000
00000000488881000000000000000000000000000000000000000000000000
00000000266663000000000000000000000000000000000000000000000000
00000000000000000000000000000000000000000000000000000000000000
00000000000000000000000000000000000000000000000000000000000000
00000000000000000000000000000000000041000000000000000000000000
00000000000000000000000000000000000023000000000000000000000000
00000000000000000000048888881000000000000000000000000000000000
0000000000000000000007EEEEEE5000000000000000000000000000000000
0000000000000000000007EEEA663000000000000000000000000000000000
00004888888100000000026663000000000000000000000000000000000000
00007EEEEEE500000000000000000000000000000000000000000000000000
00007EEEEEE500000000000000000000000000488888888100000000000000
00007EEEEEE500000000000000000000000488CEEEEEEEE500000000000000
00007EEEEEED888100041000000000000007EEEEEEEEEEE500000000000000
0000266BEEEEEEE500023000000000000007EEEEEEEEEEE500000000000000
00000007EEEEEEE500000000000000000002666BEEEA666300000000000000
0000000266666663000000000000000000000007EEE5000000000000000000
00000000000000000000000000000000000000026663000000000000000000
00000000000000000000000000000000000000000000000000000000000000
